+----------+
|   |      |
+ + + +--+ |
| |  I   |  
+ +-+ +  +++
| |   |    |
+-+-----+--+
